{
  "stageNo": 4,
  "column" : 7,
  "row" : 7,
  "table": [
    1, 1, 1, 1, 1, 1, 1,
    1, 0, 0, 0, 0, 0, 1,
    1, 0, 1, 1, 1, 0, 1,
    1, 0, 1, 0, 1, 0, 1,
    1, 0, 1, 0, 1, 0, 1,
    1, 2, 1, 0, 0, 0, 1,
    1, 1, 1, 1, 1, 1, 1
  ]
}