{
  "stageNo": 5,
  "column" : 10,
  "row" : 9,
  "table": [
    1, 1, 1, 1, 1, 1, 1, 1, 1,
    1, 0, 0, 0, 0, 0, 0, 0, 1,
    1, 0, 1, 1, 1, 1, 1, 0, 1,
    1, 0, 1, 0, 0, 0, 1, 0, 1,
    1, 0, 1, 0, 1, 0, 1, 0, 1,
    1, 0, 1, 0, 1, 0, 1, 0, 1,
    1, 0, 1, 0, 1, 1, 1, 0, 1,
    1, 0, 1, 0, 0, 0, 0, 0, 1,
    1, 2, 1, 1, 1, 1, 1, 1, 1,
    1, 1, 1, 1, 1, 1, 1, 1, 1
  ]
}