{
  "stageNo": 2,
  "column" : 7,
  "row" : 5,
  "table": [
    1, 1, 1, 1, 1,
    1, 2, 0, 0, 1,
    1, 0, 1, 0, 1,
    1, 0, 1, 0, 1,
    1, 0, 1, 0, 1,
    1, 0, 0, 0, 1,
    1, 1, 1, 1, 1
  ]
}