{
  "stageNo": 9,
  "column" : 10,
  "row" : 10,
  "table": [
    1, 1, 1, 1, 1, 1, 1, 1, 1, 1,
    1, 0, 0, 0, 0, 0, 1, 1, 1, 1,
    1, 0, 1, 1, 1, 1, 1, 1, 1, 1,
    1, 0, 0, 0, 0, 0, 0, 0, 0, 1,
    1, 0, 0, 1, 1, 1, 1, 1, 0, 1,
    1, 0, 0, 1, 0, 0, 0, 1, 0, 1,
    1, 0, 0, 0, 0, 0, 0, 1, 0, 1,
    1, 1, 0, 1, 0, 1, 1, 1, 0, 1,
    1, 1, 2, 1, 0, 0, 0, 0, 0, 1,
    1, 1, 1, 1, 1, 1, 1, 1, 1, 1
  ]
}