{
  "stageNo": 3,
  "column" : 7,
  "row" : 7,
  "table": [
    1, 1, 1, 1, 1, 1, 1,
    1, 0, 0, 0, 0, 0, 1,
    1, 0, 1, 1, 1, 1, 1,
    1, 0, 0, 0, 0, 0, 1,
    1, 1, 1, 1, 1, 0, 1,
    1, 2, 0, 0, 0, 0, 1,
    1, 1, 1, 1, 1, 1, 1
  ]
}